111111111111111111111111111111
1P000000CC0000000000C000000E01
10C00010CC01000000C00000000001
100C000111100000C000000C000001
100000100001000000C00000000001
10000C000000011101110110110001
100000000C00001001010101010001
10C000000000001001110100010001
100000000C000000000000000C0001
111111111111111111111111111111