1111111111
100100C001
100100C001
10P111ECC1
10CCCCCCC1
1111111111