11111111111111111111111111111111111111111111111111111
10000000CC0000000000C000011E11000000000P0000000000001
10C00010CC00000000C0000001101100000000000000000000001
1000000111111000C000000C00101000000000000000000000001
10000010000C000000C0000000000000000000000000000000011
10000C00000001110111011011000000000000000000000000001
100000000C0000100101010101000000000000000000000000001
10C00000000000100111010001000000000000000000111111101
10000000000000000000000000000000000000000000100000001
10001000011000C000000011111111111111111C0000000011111
1001000010010000000111C00C00000000000000000C000000011
1010000000100000000100000C000000000000000000000000011
11001000010000C000010000000000000000000C0000000000011
1111111010000000000100C00000000000000000000C000000011
10001000111100000001000000000000000000000000000000011
11111111111111111111111111111111111111111111111111111