1111111111
1001E0C001
10P1111011
1000C00C01
111111111