1111111111111111111111111111111111111111111111111111111111111111111111111111111111111111111111111111111111
10000000CC0000000000C000011E11000000000100000000000010000000CC0000000000C000011111000000000P00000000000011
10C00010CC00000000C00000011011000000000000000000000010000000CC0000000000C000011111000000000000000000000011
1000000111111000C000000C001010000000000000000000000010000000CC0000000000C000011111000000000100000000000011
10000010000C000000C00000000000000000000000000000000110000000CC0000000000C000011111000000000100000000000011
10000C000000011101110110110000000000000000000000000010000000CC0000000000C000011111000000000100000000000011
100000000C00001001010101010000000000000000000000000010000000CC0000000000C000011111000000000100000000000011
10C000000000001001110100010000000000000000001111111010000000CC0000000000C000011111000000000100000000000011
1010000000100000000100000C0000000000000000000000000110000000CC0000000000C000011111000000000100000000000011
11001000010000C000010000000000000000000C00000000000110000000CC0000000000C000011111000000000100000000000011
1111111010001100000100C00000000000000000000C0000000110000000CC0000000000C000011111000000000100000000000011
100010001111000000010000000000000000000000000000000110000000CC0000000000C000011111000000000100000000000011
1111111010001000000100C00000000000000000000C0000000110000000CC0000000000C000011111000000000100000000000011
1111111010000000000100C00000000000000000000C0000000110000000CC0000000000C000011111000000000100000000000011
1111111010000000000100C00000000000000000000C0000000110000000CC0000000000C000011111000000000100000000000011
1111111010000000000100C00000000000000000000C0000000000000000CC0000000000C000011111000000000100000000000011
1111111010000000000100C00000000000000000000C0000000110000000CC0000000000C000011111000000000100000000000011
1111111010000000000100C00000000000000000000C0000000110000000CC0000000000C000011111000000000100000000000011
1111111010000000000100C00000000000000000000C0000000110000000CC0000000000C000011111000000000100000000000011
1111111010000000000100C00000000000000000000C0000000110000000CC0000000000C000011111000000000100000000000011
1111111010000000000100C00000000000000000000C0000000110000000CC0000000000C000011111000000000100000000000011
1111111010000000000100C00000000000000000000C0000000110000000CC0000000000C000011111000000000100000000000011
1111111010000000000100C00000000000000000000C0000000110000000CC0000000000C000011111000000000100000000000011
1111111010000000000100C00000000000000000000C0000000110000000CC0000000000C000011111000000000100000000000011
1111111010000000000100C00000000000000000000C0000000110000000CC0000000000C000011111000000000100000000000011
1111111010000000000100C00000000000000000000C0000000110000000CC0000000000C000011111000000000100000000000011
1111111010000000000100C00000000000000000000C0000000110000000CC0000000000C000011111000000000100000000000011
1111111010000000000100C00000000000000000000C0000000110000000CC0000000000C000011111000000000100000000000011
1111111010000000000100C00000000000000000000C0000000110000000CC0000000000C000011111000000000100000000000011
1111111010000000000100C00000000000000000000C0000000110000000CC0000000000C000000000000000000100000000000011
1111111010000000000100C00000000000000000000C0000000110000000CC0000000000C000011111000000000100000000000011
1111111010000000000100C00000000000000000000C0000000110000000CC0000000000C000011111000000000100000000000011
1111111010000000000100C00000000000000000000C0000000110000000CC0000000000C000011111000000000100000000000011
1111111010000000000100C00000000000000000000C0000000110000000CC0000000000C000011111000000000100000000000011
1111111010000000000100C00000000000000000000C0000000110000000CC0000000000C000011111000000000100000000000011
1111111010000000000100C00000000000000000000C0000000110000000CC0000000000C000011111000000000100000000000011
1111111111111111111111111111111111111111111111111111111111111111111111111111111111111111111111111111111111