1111111111
1001E0C001
10P1111001
1000C0PC01
1111111111