1111111111
1001E0C001
0P11110110
1000C00C01
1111111111
1111111111
1111111111
1111111111
1111111111
1111111111
1111111111