1111111111
1001E0C001
1P11110111
1000C00C01
1111111011