1111111111
1001000001
10P1111001
100000E001
1111111111