1111111111
1001E0C001
0P11110111
1000C00C01
1111111111