1111111111
1P000C01E1
1111111111