1111111111
1001E0C001
10P111101
1000C00C01
1111111111