11111P1111
1001000P01
10P1111001
100E00E001
1111111111