11111111111111111111
100100CE010000000001
100100C0010000000001
10P1110CC10000001111
10CCC001100000001C01
11111111111111111111